QQQQQQQQQQQQQQQQQQQQQQQQQQQQQQQQQ
QBBBBBQBQBBBDDIDDBBBBBBBBBBBBBBBQ
QBBBBBBpBBBBBBIBBBBBBBBBBBBBBBBBQ
QBBBBBQBQBBBDDIDDBBBBBBBBBBBBBBBQ
QBBBBBBBBBBBDDIDDBBBBBBBBBBBBBBBQ
QBBBBBBBBBBBBBIDDBBBBBBBBBBBBBBBQ
QBBBBBBBBBBBDDIBBBBBBBBBBBBBBBBBQ
QBBBBBBBBBBBDDIDDBBBBBBBBBBBBBBBQ
QBBBBBBBBBBBDDIDDBBBBBBBBQBQBBBBQ
QBBBBBBBBBBBBBIBBBBBBBBBBBPBBBBBQ
QBBBBBBBBBBBDDIDDBBBBBBBBQBQBBBBQ
QQQQQQQQQQQQQQQQQQQQQQQQQQQQQQQQQ
