QQQQQQQQQQQQQQQQQQQQQQQQQQQQQQQQQ
QBBBBBBBBBBBDDIDDBBBBBBBBBBBBBBBQ
QBBBBBBpBBBBBBIBBBBBBBBBBBBBBBBBQ
QBBBBBBBBBBBDDIDDBBBBBBBBBBBBBBBQ
QBBBBBBBBBBBBBIBBBBBBBBBBBPBBBBBQ
QBBBBBBBBBBBDDIDDBBBBBBBBBBBBBBBQ
QQQQQQQQQQQQQQQQQQQQQQQQQQQQQQQQQ
